"EV001",""
"EV002",""
"EV003",""
"EV004",""
"EV005",""
"EV006",""
"EV007",""
"EV008",""
"EV009",""
"EV010",""
"鍵がかかっている。","It's locked."
"EV011",""
"EV012",""
